WWWWWWWWWWWWWWWWWWWWW
PSWPPPPPPPWPPPPPPPPPW
WPWPWPWWWWWPWPWWWWWPW
WPPPWPPPPPWPWPWPPPWPW
WWWWWPWWWPWPWPWPWPWWW
WPWPPPWPPPWPWPPPWPPPW
WPWPWPWPWWWPWPWWWWWPW
WPPPWPWPWPPPWPPPWPPPW
WWWWWPWPWWWWWWWPWPWWW
WPPPPPWPPPPPPPWPWPWPW
WPWWWWWWWWWWWPWPWPWPW
WPWPWPPPPPPPWPPPWPWPW
WPWPWPWWWWWWWPWWWPWPW
WPPPWPPPPPPPPPWPPPPPW
WPWWWWWWWWWPWWWPWWWWW
WPPPPPPPPPWPPPWPPPPPW
WPWWWWWWWPWPWPWWWPWPW
WFWPPPPPWPWPWPPPWPWPW
WPWPWWWPWWWPWWWWWPWPW
WPPPWPPPPPPPPPPPPPWPP
WWWWWWWWWWWWWWWWWWWWW
