WWWWPPPPPPPPPWWWWW
WWWWPPPPHPPPPWWWWW
WWWWPPWWWWWPPWWWWW
WWWWPPWWWWWPPWWWWW
WWWWPPWWWWWPPWWWWW
WWWWPPWWWWWPPWWWWW
SPPPPPPPPPPPPPPPPF
